Atlanta Hawks: Mike Budenholzer 
Boston Celtics: Brad Stevens 
Brooklyn Nets: Kenny Atkinson 
Charlotte Hornets: Steve Clifford 
Chicago Bulls: Fred Hoiberg 
Cleveland Cavaliers: Tyronn Lue 
Detroit Pistons: Stan Van Gundy 
Indiana Pacers: Nate McMillan 
Miami Heat: Erik Spoelstra 
Milwaukee Bucks: Jason Kidd 
New York Knicks: Kurt Rambis (interim) 
Orlando Magic: TBA 
Philadelphia 76ers: Brett Brown 
Toronto Raptors: Dwane Casey 
Washington Wizards: Scott Brooks
Western Conference
Dallas Mavericks: Rick Carlisle 
Denver Nuggets: Mike Malone 
Golden State Warriors: Steve Kerr 
Houston Rockets: TBA 
L.A. Clippers: Doc Rivers 
L.A. Lakers: Luke Walton 
Memphis Grizzlies: TBA 
Minnesota Timberwolves: Tom Thibodeau 
New Orleans Pelicans: Alvin Gentry 
Oklahoma City Thunder: Billy Donovan 
Phoenix Suns: Earl Watson 
Portland Trail Blazers: Terry Stotts 
Sacramento Kings: Dave Joerger 
San Antonio Spurs: Gregg Popovich 
Utah Jazz: Quin Snyder
